7 9
landPath,flyPath,towerPos,forbidden,x,y
1 0 0 0 0 0
1 0 0 0 0 1
1 0 0 0 0 2
1 0 0 0 0 3
1 0 0 0 0 4
1 0 0 0 0 5
1 0 0 0 0 6
1 0 0 0 0 7
1 0 0 0 0 8
1 0 0 0 1 0
0 0 0 1 1 1
0 0 0 1 1 2
0 0 0 1 1 3
0 0 0 1 1 4
0 0 0 1 1 5
0 0 0 1 1 6
0 0 0 1 1 7
0 0 0 1 1 8
1 0 0 0 2 0
0 0 0 1 2 1
0 0 1 0 2 2
0 0 1 0 2 3
0 0 0 1 2 4
0 0 0 1 2 5
0 0 0 1 2 6
0 0 0 1 2 7
0 0 0 1 2 8
1 0 0 0 3 0
0 0 0 1 3 1
0 0 0 1 3 2
0 0 0 1 3 3
0 0 0 1 3 4
0 0 0 1 3 5
0 0 0 1 3 6
0 0 0 1 3 7
0 0 0 1 3 8
0 0 0 1 4 0
0 0 0 1 4 1
0 0 0 1 4 2
0 0 0 1 4 3
0 0 0 1 4 4
0 0 0 1 4 5
0 0 0 1 4 6
0 1 0 0 4 7
0 0 0 1 4 8
0 0 0 1 5 0
0 0 0 1 5 1
0 0 0 1 5 2
0 0 0 1 5 3
0 0 0 1 5 4
0 0 0 1 5 5
0 0 0 1 5 6
0 1 0 0 5 7
0 0 0 1 5 8
0 0 0 1 6 0
0 0 0 1 6 1
0 0 0 1 6 2
0 0 0 1 6 3
0 0 0 1 6 4
0 0 0 1 6 5
0 0 0 1 6 6
0 1 0 0 6 7
0 1 0 0 6 8
ground
1 0
0 0
0 1
0 2
0 3
0 4
0 5
0 6
0 7
0 8
ground
1 0
2 0
3 0
fly
6 7
6 8
fly
6 7
5 7
4 7